========================================
=    ----------------------------------=
=  2 ---------               ------=---=
=    --------- ------------- ------=---=
=      ------- ------------- ------=---=
=----   ------ ------====-=-=--=-=-=---=
=-----   ----- ------=------ ----------=
=------   ---- ------=------ ----------=
=-------   --- ------=------ ----------=
=--------   --  -----=------ ----------=
=---------          ==          -------=
=------------ ------=-----  --   ------=
=------------ ------=------ ---   -----=
=------------ ------=------ ----   ----=
=------------ ------=------ -----   ---=
=-----=-=-=--=-=-====------ ------     =
=-----=------ ------------- -------    =
=-----=------ ------------- ------- 1  =
=-----=------               -------    =
=----------------------------------    =
========================================