========================================
=                                      =
= 2                                 1  =
=   =====================              =
=       --                  ==   =     =
=       --                  ==   -     =
=       --                  ==   -     =
=       =-     =========    ==   =     =
=   =   =-                   =   -     =
=   -   ==                   =   -     =
=   -    =                   =   ==    =
=   ==   =                   =    -    =
=    -   =                   ==   -    =
=    -   =                   -=   =    =
=    =   ==    =========     -=        =
=    -   ==                  --        =
=    -   ==                  --        =
=    =   ==                  --        =
=              =====================   =
=                                      =
=                                      =
========================================